1111111111
1000000001
100C00E001
1000000001
100000C001
10000C0001
1000P0C001
100000C001
1000000001
1111111111