1111111111
1222222221
1224222221
1222222221
1222224221
1222232221
1222222221
1224222221
1222222221
1111111111