1111111111
1000000E01
100C000001
1000000001
100000C001
10000C0001
1000P00001
100C000001
1000000001
1111111111